#######
#S....#
#.###.#
#.###.#
#.###.#
#L.L.L#
#######